NO      ./pafsd     



EA ./path_to_the_east_texture




F                  1,2,100
SO ./path_to_the_south_texture


C 8,30,0
WE ./path_to_the_west_texture






        1111111111111111111111111
        1000000000110000000000001
        1011000001110000000000001
        1001000000000000000000001
111111111011000001110000000000001
100000000011000001110111111111111
11110111111111011100000010001
1111011111111011101010010001
11000000110101011100000010001
10000000000000001100000010001
100000000000000011010100100011
1100000111010101111101111000N1
11110111 1110101 1011110100011
11111111 1111111 111111111111
