C 224,2,2

NO ./srcs/img/north.xpm 
EA ./srcs/img/east.xpm
SO ./srcs/img/south.xpm
WE ./srcs/img/west.xpm


F 220,100,0



1111111111111
10111000111111
10000000000111
10000000000111
10000S00001111
10000000110111
11111111111111
