NO      ./srcs/img/north.xpm 



EA ./srcs/img/east.xpm




F                  1,2,100
SO ./srcs/img/south.xpm


C 8,30,0
WE ./srcs/img/west.xpm






        1111111111111111111111111
        1E00000000110000000000001
        1011000001110000000000001
        1001000000000000000000001
111111111011000001110000000000001
100000000011000001110111111111111
11110111111111011100000010001
11110111111110111010100100001111
11000000110101011100000010001
10000000000000001100000010001
10000000000000001101010010001
11000001110101011111011110001
11110111 1110101 101111010011
11111111 1111111 111111111111
 1111        1
 1001
 1001
 1001
 1001
11111
