



C                8,30,0
NO ./srcs/img/north.xpm 


         SO ./srcs/img/south.xpm
F                  1,1,100

EA ./srcs/img/east.xpm

WE ./srcs/img/west.xpm



        1111111111111111111111111
        10000000001100000000000011
       11101100000111000000000001
        10010000001111100000000011
111111111011000001110000000000001
100000000011000001110111111111111
111101111111110111000000100011
11110111111110111010100100001111
110000001101010111000N0010001
10000000000000001100000010001
10000000000000001101010110001
11000001110101011111011110001
11110111 1110101 101111010011
11111111 1111111 111111111111
 1111        1
 1001
 1001
 1001
 1001
11111
