1234123412111111
1000000000000001
1000000011111111
1000000000000001
1000000000110001
10000001111111111111111111111111111111111111
10000000001100000000000000000000000000000001
10000000000000000000000000000000000000000001
10000000001100000000000000000000000000000001
11111111111111111111111111111111111111111111
